1111111111111
1P000000000C1
1000011111001
1000000000001
1000111000011
1E100000001C1
1111111111111